尼薩耆波逸提法	nísàqí bōyìtí fǎ	rules of forfeiture of the things that a monk or nun possesses superfluously    
波羅提提舍尼法	bōluótítíshèní fǎ	(four lesser) offenses (concerning meals) which are to be confessed    
僧伽婆尸沙法	sēngqié póshīshā fǎ	crimes against the saṃgha    
尼薩耆波逸提	nísàqí bōyìtí	rules of forfeiture of the things that a monk or nun possesses superfluously    
自淨其志意	zìjìng qí zhìyì	purify your intentions    
拘那含牟尼	Jūnàhánmóuní	Kanakamuni (Buddha)    
是事如是持	shìshì rúshì chí	thus I will bear it in mind    
僧伽婆尸沙	sēngqiépóshīshā	crimes for which one may not necessarily be excommunicated    
以是因緣	yǐ shì yīnyuán	by these causes and conditions    
佛所說法	fó suǒ shuōfǎ	teaching given by the Buddha    
受具足戒	shòu jùzú jiè	to receive full ordination    
於佛法中	yú fófǎ zhōng	within the Buddhist teaching    
無數方便	wúshǔ fāngbiàn	countless skillful means    
波利婆沙	bōlìpóshā	(Skt. parivāsa)    
作如是說	zuò rúshì shuō	makes this kind of explanation    
莫作是語	mò zuò shì yǔ	don't say such a thing    
迦絺那衣	jiāchīnà yī	kaṭhina-robe    
作如是語	zuò rúshì yǔ	spoke in this way…    
波逸提法	bōyìtí fǎ	(minor) offenses requiring expiation    
半月半月	bànyuè bànyuè	every half a month    
稽首禮	jīshǒulǐ	to make obeisance    
釋迦文	Shìjiāwén	Śākyamuni    
何以故	héyǐgù	why is it so?    
好覆身	hǎofùshēn	to cover the body well    
安樂住	ānlè zhù	to abide in realization of comfort    
我今說	wǒjīnshuō	I will now explain…    
戒經序	jièjīng xù	the introduction of the Prâtimokṣa-sūtra    
王大臣	wángdàchén	prime minister to the king    
摩那埵	mónàtuo	joy    
展轉相	zhǎn zhuǎn xiāng	one after another    
不淨施	bùjìng shī	impure donation    
不發露	bùfālù	does not reveal    
經行處	jīngxíng chù	a place for walking up and down    
拘留孫	Jūliúsūn	Krakucchanda    
僧羯磨	sēngjiémó	approval from the saṃgha    
反抄衣	fǎnchāo yī	robes turned inside out    
如法治	rúfǎ zhì	corrected according to the rules    
婬欲意	yínyù yì	lustful mind    
於異時	yú yì shí	at another time    
滅諍法	mièzhēngfǎ	rules for settling disputes    
若不得	ruò bùdé	if it is not obtained    
說戒時	shuōjièshí	when expounding the precepts    
故妄語	gùwàngyǔ	intentional lie    
諸佛教	zhū fójiào	teaching of the Buddhas    
嚼楊枝	jiáo yángzhī	chewing the tooth stick at daybreak, 晨    
優婆夷	yōupóyí	upāsikā    
可呵法	kěhē fǎ	repenting crimes to others    
悔過法	huǐguò fǎ	repenting crimes to others    
自恣請	zìzìqǐng	special invitation    
不定法	bùdìng fǎ	indeterminate mental factors    
亦如是	yì rúshì	also like this    
僧伽藍	sēngqiélán	(Skt. saṃghârāma)    
和合僧	héhé sēng	gathering of monks    
無所著	wú suǒzhùo	no attachment    
等正覺	děngzhèng jué	perfect supreme enlightenment    
行惡行	xíng èxíng	to engage in unwholesome activities    
除餘時	chúyúshí	except at the [right] occasion    
大小便	dàxiǎobiàn	to urinate and defecate    
作是語	zuòshì yǔ	to say this    
如是語	rúshì yǔ	these words    
非親里	fēi qīnlǐ	not related    
默然故	mòrángù	because of (their) silence…    
波羅夷	bōluóyí	pārājika    
比丘尼	bǐqiūní	bhikṣuṇī    
諸比丘	zhū bǐqiū	bhikṣus    
白衣舍	bái yī shè	the home of a white-clothed layman    
應當學	yìngdāngxué	to be instructed or taught    
波逸提	bōyìtí	(minor) offenses requiring expiation    
若比丘	ruò bǐqiū	if a monk…    
虛誑	xūkuáng	deceit    
稽首	qǐshǒu	worship by bowing oneʼs head to the Buddhaʼs feet    
兜羅	dōuluó	floss;    
闇冥	ànmíng	ignorant    
叉腰	chāyāo	arms akimbo    
勢力	shìlì	momentum    
採華	cǎihuā	pick flowers    
私通	sītōng	liaison    
宮門	gōngmén	palace gate    
迦文	Jiāwén	Śākyamuni    
鬼神	guǐshén	spirit    
進退	jìntuì	advancing and regressing    
賣買	màimǎi	to buy and sell    
媒嫁	méijià	pandering    
城邑	chéngyì	city    
羅門	luómén	Brahman    
欣慼	xīnqī	joy and sorrow    
放逸	fàngyì	negligence    
由旬	yóuxún	yojana    
罽賓	Jìbīn	Jibin    
村落	cūnluò	villages    
遺落	yíluò	neglect    
威儀	wēiyí	deportment    
雜碎	zá suì	miscellaneous    
親厚	qīnhòu	an especially deep relationship    
販賣	fànmài	sales of goods    
照鏡	zhàojìng	to look at oneself in a mirror    
恐懼	kǒngjù	fear    
遙擲	yáozhí	to abandon distantly    
疾疾	jíjí	swiftly    
弄陰	nòngyīn	to play with the private parts    
不諍	bùzhēng	does not quarrel    
且止	qiězhǐ	refrain (stop) for the time being    
來入	láirù	to enter    
僧戒	sēngjiè	monks precepts    
僧房	sēngfáng	monkʼs dormitory    
同罪	tóngzuì	same offense    
善哉	shànzāi	excellent!    
喜樂	xǐyuè	delight    
左右	zuǒyòu	left and right    
師學	shīxué	master and disciple    
我見	wǒjiàn	self-view    
所覆	suǒfù	covered    
扠腰	chāyāo	arms akimbo    
掉臂	diàobì	to get up    
搖身	yáoshēn	to sway the body    
有主	yǒuzhǔ	to have ownership    
有增	yǒuzēng	there is more    
有如	yǒurú	as-it-is    
有怖	yǒubù	fearful    
有愛	yǒuài	attachment to existence    
有癡	yǒuchī	having delusion    
欲作	yùzuò	desire to do    
歎譽	tànyù	to praise and glorify    
歡喜	huānxǐ	happiness    
毀戒	huǐjiè	violate the precepts    
法說	fǎshuō	to explain theoretically    
無主	wúzhǔ	unowned    
燒衣	shāo yī	fire-burnt kaṣāya    
男子	nánzǐ	son    
縱廣	zòngguǎng	length and breadth    
自捉	zìzhuō	grasping on oneʼs own    
莫謗	mòbàng	do not    
貿易	màoyì	trade    
靜默	jìngmò	quiet    
顧視	gùshì	reviewing and inspecting    
事中	shìzhōng	within phenomena    
覆藏	fùzàng	concealing    
有罪	yǒuzuì	to be encumbered with faults    
尼衣	níyī	nunʼs robes    
佛道	fódào	buddha-way    
受已	shòuyǐ	having received...    
未滿	wèimǎn	incomplete    
當受	dāng shòu	to be taken or received    
人法	rénfǎ	person and dharma    
飲食	yǐnshí	drink and food    
中住	zhōngzhù	abide in the center    
牽出	qiānchū	to draw out    
富羅	fùluó	pula    
更增	gēngzēng	additional    
教誡	jiàojiè	instruction    
久住	jiǔzhù	to stay a long time    
已入	yǐrù	has entered    
智慧	zhìhuì	wisdom    
精進	jīngjìn	diligence    
處住	chùzhù	abode    
心定	xīndìng	mental equipoise    
供養	gongyǎng	to make offerings    
佛像	fóxiàng	an image of the Buddha    
覆處	fùchù	covered place    
殷勤	yīnqín	zealous    
佛說	fóshuō	Buddhaʼs sermon    
佛衣	fóyī	Buddhaʼs robe    
熾盛	chìshèng	to flourish    
諸惡	zhūè	various evil [activities]    
迦葉	Jiāshè	Kāśyapa    
靜處	jìngchù	quiet place    
檀越	tán yuè	chief donor    
釋迦	shìjiā	Śākya    
不善	bùshàn	unwholesome    
不癡	bùchī	not perplexed    
在前	zàiqián	to be manifest    
坐具	zuòjù	a sitting cloth    
大姊	dàjiě	venerable sister    
已出	yǐchū	arisen    
戲笑	xìxiào	merriment    
捨去	shěqù	to avoid    
教授	jiàoshòu	to teach    
是法	shì fǎ	this teaching    
有疑	yǒuyí	to have doubts    
自身	zìshēn	self    
與僧	yǔsēng	to the saṃgha    
若無	ruòwú	if there is no...    
莊飾	zhuāngshì	to adorn    
覆頭	fùtóu	with the face covered    
語言	yǔyán	to say    
遶塔	ràotǎ	circumambulate a stūpa    
齊整	qízhěng	well-arranged    
皆共	jiēgòng	all    
惱他	nǎotā	cause distress to others    
布薩	bùsà	(Skt. poṣadha)    
沙門	shāmén	śramaṇa    
露地	lòudì	bare ground    
欲求	yùqiú	desire, craving, aspiration    
弟子	dìzí	student    
新衣	xīnyī	new robes    
摩那	mónà	mana    
不喜	bùxǐ	not enjoying    
我等	wǒ děng	we    
我說	wǒshuō	I say...    
欲壞	yùhuài	to wish to ruin    
淨行	jìngxíng	to practice (behavior) of purity    
病時	bìngshí	times of illness    
繩床	shéngchuáng	a rope-bottomed folding chair    
非餘	fēiyú	not other (than)    
食竟	shíjìng	finish eating    
得生	déshēng	obtain [re-]birth    
若有	ruòyǒu	if it were    
不與	bùyǔ	not given    
革屣	géxǐ	leather slippers    
大戒	dàjiè	full set of precepts    
恐怖	kǒngbù	to fear    
無根	wúgēn	lacking ability    
楊枝	yángzhī	willow twigs    
涕唾	tìtuò	saliva    
瞋恚	chēnhuì	aversion    
自言	zìyán	to admit    
道行	dàoxíng	conduct accordant with the way    
中有	zhongyǒu	intermediate state    
障道	zhàngdào	obstacle to the way    
壞色	huàisè	yellow-brown [robe]    
未受	wèishòu	not yet experienced    
展轉	zhǎn zhuǎn	in order    
羊毛	yángmáo 	sheep goat wool    
不作	bùzuò	does not do    
處所	chùsuǒ	place    
可呵	kěhē	contemptible    
憶念	yìniàn	to remember    
方便	fāngbiàn	skillful means    
共住	gòngzhù	dwelling together    
諸佛	zhūfó	the buddhas    
執事	zhíshì	a manager    
受食	shòushí	to receive (donations of) food    
發露	fālù	to disclose    
某甲	mǒu jiǎ	someone or another    
法中	fǎzhōng	amidst phenomena    
羯磨	jiémó	karman    
涅槃	nièpán	nirvana    
自手	zìshǒu	oneʼs own hand    
女人	nǚrén	woman    
沙彌	shāmí	śrāmaṇera    
毘尼	píní	(Skt. vinaya)    
是時	shì shí	this time    
如法	rúfǎ	according to the Dharma    
中說	zhōngshuō	to teach in the midst of    
聚落	jùluò	a village    
當與	dāngyǔ	will give    
如來	rúlái	thus-come    
應與	yìngyǔ	to be asked    
無所	wúsuǒ	no object    
因緣	yīnyuán	cause(s) and condition(s)    
不受	bùshòu	not appropriating    
他比	tābǐ	reasoning for others    
無病	wúbìng	free from disease    
臥具	wòjù	couch    
臥具	wòjù	bedding    
佛塔	fótǎ	(Skt. buddha-stūpa)    
人說	rénshuō	someone says    
教人	jiàorén	to teach others    
悔過	huǐguò	repentance of transgressions    
所說	suǒshuō	that which is explained    
得衣	déyī	to obtain clothing    
婬欲	yínyù	sexual desire    
世尊	shìzūn	world-honored one    
餘時	yúshí	another time    
和合	héhé	unified    
默然	mòrán	to be silent    
是事	shì shì	these things    
若不	ruòbù	if not,...    
說戒	shuōjiè	explaining the precepts    
居士	jūshì	a householder    
若過	ruòguō(pass)guò(error)	also increasing    
已說	yǐshuō	have (already) explained    
乃至	nǎizhì	up to    
除病	chúbìng	to remove disease    
戒經	jièjīng	pratimokṣa-sūtra    
如是	rúshì	like this    
大德	dàdé	great virtue    
不得	bùdé	impossible    
比丘	bǐqiū	(Skt. bhikṣu)    
依	yī	support    
全	quán	all    
初	chū	beginning    
劍	jiàn	a sword    
功	gōng	efficacy    
勇	yǒng	brave    
勿	wù	no    
厭	yàn	to be wearied with    
各	gè	each    
味	wèi	flavor    
咄	duò	bah! hey!    
咸	xián	together    
唱	chàng	to call out    
器	qì	receptacle    
國	guó	a country    
埋	mái	to cover up    
堪	kān	to bear    
報	bào	retribution    
塞	sè ● sāi	to close    
墮	duò	to fall    
夢	mèng	to dream    
央	yāng	middle    
始	shǐ	beginning    
嫉	jí	jealousy    
孔	kǒng	hole    
室	shì	abode    
寂	jì	to become quiet    
寧	níng	to stop    
尾	wěi	tail    
崖	yá ● yái	a steep bank    
張	zhāng	extended    
形	xíng	form    
待	dài	to wait    
御	yù	to steer    
急	jí	haste    
性	xìng	nature    
怯	qiè	to falter    
悲	bēi	pity    
惟	wéi	think    
想	xiǎng	ideation    
愁	chóu	anguish    
愚	yú	naïve    
慚	cán	conscience    
慢	màn	pride    
懺	chàn	repentance    
截	jié	to cut off    
把	bǎ	to grasp    
折	zhé	to fold    
挑	tiǎo(arouse) ● tiāo (select, carry)	to put up    
振	zhèn	to shake    
損	sǔn	to negate    
搏	bó	to strike with the fist    
擔	dān	to carry    
擘	bò	to split    
散	sàn	to scatter    
敬	jìng	to respect,    
文	wén	a text    
曇	tán	clouds    
曉	xiǎo	to awaken    
曹	cáo	class    
服	fú	to wear    
望	wàng	with regard to    
梐	bì	fence    
梵	fàn	brahman    
業	yè	activity    
極	jí	very    
樹	shù	a tree    
次	cì	next    
殺	shā	to kill    
民	mín	the people    
永	yǒng	forever    
油	yóu	oil    
況	kuàng	still more    
泥	ní	mud    
活	huó	to be lively    
涉	shè	to go over    
深	shēn	profound    
渡	dù	cross over    
漏	lòu	contamination    
演	yǎn	to give a sermon    
火	huǒ	fire    
炙	zhì	to broil    
熱	rè	heat    
牙	yá	tooth    
牛	niú	ox    
牢	láo	a pen    
界	jiè	realm    
瘡	chuāng	tumor    
百	bǎi	hundred    
眼	yǎn	eye    
石	shí	stone    
禁	jīn	prohibition    
秦	qín	a fine strain of rice    
穢	huì	to defile    
空	kōng	emptiness    
節	jié	joint    
結	jié	to tie up    
綴	zhuì	to bind    
緻	zhì	fine    
縷	lǚ	thread    
繫	jì	to be tied    
美	měi	fine    
羸	léi	weak    
羺	nóu	mountain goat    
耶	yé	transliteration of the jha or ya sound into Chinese    
聰	cōng	wise    
聲	shēng	voice    
肉	ròu	flesh    
肩	jiān	shoulder    
興	xīng	to raise    
舐	shì	to lick    
舒	shū	to stretch out    
般	bān	a sort    
苫	shān	straw mat    
蓋	gài	to cover    
薰	xūn	to perfume    
蜂	fēng	bee(s)    
裹	guǒ	to wrap    
角	jiǎo	horn    
訾	zǐ	criticize    
誦	sòng	to recite    
誰	shuí	who?    
謂	wèi	to say    
識	shí ● shì	to know    
譯	yì	reason    
讚	zàn	to praise    
象	xiàng	to resemble    
貫	guàn	to go through    
貯	zhǔ	to stock up    
蹲	dūn	to crouch    
軸	zhóu	a roller for a scroll    
輒	zhé	therefore    
輕	qīng	light (not heavy)    
轄	xiá	linchpin    
辱	rù	shame    
迴	huí	to turn    
遊	yóu	wander    
酪	luò	cream    
醜	chǒu	ugly    
鉾	móu	spear    
錢	qián	coin    
閣	gé	a pavilion    
陀	tuó	steep bank    
隱	yǐn	hidden    
雖	suī	even if    
頃	kuǐ	an instant    
頰	jiá	cheeks    
類	lèi	species    
風	fēng	wind    
馬	mǎ	horse    
騎	qí	to ride    
骨	gǔ	bone(s)    
髮	fǎ	hair (of the head)    
魚	yú	fish    
麨	chǎo	broken dry rice    
野	yě	wilderness  
蠶	cán	silkworm  
勸	quàn	to exhort    
夏	xià	summer    
屋	wū	roof    
帖	tiē	a bundle    
快	kuài	pleasure    
春	chūn	spring    
本	běn	root    
筒	tǒng	bamboo tube    
蜜	mì	honey    
逈	jiǒng	far    
銀	yín	silver    
鍼	zhēn	needle    
賊	zéi	thief    
酥	sū	clarified butter    
打	dǎ	to strike    
掘	jué	dig    
寄	jì	a basis    
沒	mò	to sink    
減	jiǎn	to decrease    
平	píng	level    
索	suǒ	rope    
阿	ā ● ē	short Sanskrit a and the long Sanskrit ā    
練	liàn	to train    
愧	kuì	shame    
香	xiāng	odor    
觸	chù	contact    
刀	dāo	sword    
答	dá	to answer    
揣	chuǎi	to estimate    
寺	sì	Buddhist temple    
財	cái	money    
洗	xǐ	to wash    
藥	yào	medicines    
差	chā	to send    
縛	fù	binding    
囑	zhǔ	to bid    
盜	dào	to steal    
伴	bàn	to accompany    
杖	zhàng	staff    
修	xiū	repeated practice    
蟲	chóng	bugs    
思	sī	to think    
命	mìng	life    
奉	fèng	to receive with both hands    
則	zé	then    
盡	jìn	to exhaust    
守	shǒu	to keep    
舌	shé	tongue    
別	bié	to distinguish    
戰	zhàn	war    
稱	chēng ● chèn	to praise    
船	chuán	boat    
片	piàn	piece    
屏	píng	to cover    
詣	yì	to reach    
避	bì	to avoid    
仙	xiān	recluse sage    
勝	shèng	superior    
直	zhí	straight    
漂	piāo	floating    
會	huì	to combine    
式	shì	ritual    
脫	tuō	release    
但	dàn	only    
畏	wèi	to be afraid    
海	hǎi	ocean; sea    
閑	xián	leisure    
金	jīn	gold    
跳	tiào	to leap    
險	xiǎn	misfortune    
乘	shèng	vehicle    
賢	xián	intelligent    
脚	jiǎo	foot    
鬪	dòu	a dispute    
重	zhòng/chóng	zhòng for meanings related to heaviness; chóng for meanings related to piling up.    
叉	chā	to clasp the hands    
綿	mián	cotton    
置	zhì	to place    
雜	zá	to mix  
浣	huàn	to wash    
纏	chán	actively binding (affliction)    
頸	jǐng	neck    
天	tiān	heaven    
陣	zhèn	a file of soldiers    
而	ér	and    
破	pò	to refute    
示	shì	to show to someone else    
殘	cán	to injure    
褥	rù	cushion    
立	lì	to establish    
少	shǎo ● shào	few    
斷	duàn	to eliminate (permanently)    
離	lí	to separate    
送	sòng	to send    
外	wài	outside    
間	jiān	space    
解	jiě	liberation    
懷	huái	yearning    
乳	rǔ	milk    
高	gāo	high    
第	dì	level    
強	qiáng	strong    
明	míng	light    
或	huò	somebody    
含	hán	to contain    
精	jīng	essential    
純	chún	pure    
譬	pì	to compare    
數	shǔ (to count) ● shù (number, factor)	to count    
檀	tán	sandalwood    
養	yǎng	nourish    
牟	móu	ox    
盛	chéng	to full up    
葉	yè ● shè	leaf    
八	bā	eight    
益	yì	increase    
還	hái	to return    
實	shí	real    
澆	jiāo	to sprinkle    
譽	yù	to praise    
獨	dú	only    
現	xiàn	to manifest    
之	zhī	of    
座	zuò	seat    
隨	suí	in accord with    
惱	nǎo	vexation    
愛	ài	to desire    
其	qí	therein    
將	jiāng ● jiàng	will    
失	shī	to be lost    
兩	liǎng	two    
覓	mì	to search for    
留	liú	to stay    
切	qiē ● qiè	to cut    
乞	qǐ	to pray for    
嚼	jiáo	to chew    
勤	qín	to strive    
雨	yǔ	rain    
期	qī	a set time    
歎	tàn	admiration    
奪	duó	to snatch    
憂	yōu	sorrow    
疑	yí	doubt    
妨	fáng	to hinder    
忍	rěn	to endure    
信	xìn	faith    
智	zhì	to know    
村	cūn	village    
皆	jiē	all    
到	dào	to reach to    
夜	yè	night    
指	zhǐ	finger    
棄	qì	to throw away    
看	kàn	to look at    
遠	yuǎn	distant    
驅	qū	to drive out or away    
遣	qiǎn	chase away    
物	wù	matter    
羹	gēng	soup    
燒	shāo	burn    
辦	bàn	to transact    
聖	shèng	saint    
口	kǒu	mouth    
屍	shī	corpse    
常	cháng	permanent    
年	nián	lunar year    
何	hé	what    
遶	rào	to circle    
戲	xì	to play    
起	qǐ	to arise    
集	jí	gather    
軍	jūn	an army    
黑	hēi	black    
草	cǎo	grass    
染	rǎn	defiled    
屍	shī	corpse    
男	nán	male    
妄	wàng	to lie    
授	shòu	to give    
布	bù	to spread    
利	lì	profit    
優	yōu	to surpass    
律	lǜ	rule    
視	shì	to look (at)    
麁	cū	rough    
九	jiǔ	nine    
聞	wén	To hear    
邊	biān	border    
敷	fū	to diffuse    
令	lìng	cause    
齊	qí	to adjust    
滿	mǎn	full    
能	néng	able to    
多	duō	many    
浴	yù	to bathe    
觀	guan	to observe    
師	shī	teacher    
主	zhǔ	lord    
障	zhàng	obstacle    
增	zēng	increase    
毀	huǐ	to defame    
成	chéng	to accomplish    
止	zhǐ	to stop    
治	zhì	to govern    
癡	chī	delusion    
相	xiàng	characteristic    
護	hù	to protect    
織	zhī	to spin thread    
王	wáng	king    
異	yì	to differ    
怖	bù	fear    
安	ān	quiet    
頭	tóu	head    
地	dì	earth    
難	nán	difficult    
五	wǔ	five    
從	cóng	to follow    
日	rì	day    
最	zuì	most    
聽	tīng	To listen very well    
謗	bàng	to slander    
求	qiú	to seek    
藏	zàng ● cáng	storage place    
恚	huì	anger    
房	fáng	monkʼs quarters    
婦	fù	a woman    
呵	hē	to criticize    
諍	zhēng	quarrel    
七	qī	seven    
名	míng	names    
寶	bǎo	jewel    
長	cháng	long    
瞋	chēn	aversion    
用	yòng	to use    
意	yì	mentation    
念	niàn	mindfulness    
喜	xǐ	delight    
先	xiān	front    
畜	xù	to store    
種	zhǒng	seed    
捉	zhuō	to grasp    
廣	guǎng	width    
堅	jiān	hard    
滅	miè	to cease    
更	gèng	still more    
六	liù	six    
往	wǎng	to go    
內	nèi	within    
後	hòu	after    
前	qián	front    
水	shuǐ	water    
好	hǎo	good    
施	shī	charity    
未	wèi	not yet    
心	xīn	heart, mind    
女	nǚ	woman    
及	jí	to reach    
量	liáng ● liàng	to measure    
須	xū	to wait    
見	jiàn	to see    
足	zú	leg    
去	qù	to leave    
正	zhèng	correct    
毘	pí	transcription of Sanskrit vi sound    
死	sǐ	to die    
同	tóng	the same    
反	fǎn	to return    
生	shēng	arising    
臥	wò	to lie down    
壞	huài	to deteriorate    
可	kě	may    
磔	zhé	to bore    
等	děng	and so forth    
犯	fàn	to commit crimes    
鉢	bo	alms bowl    
飯	fàn	food    
下	xià	lesser    
樂	lè	(1) music (2) comfort (3) to be indulged in    
身	shēn	body    
價	jià	price    
新	xīn	new    
竟	jìng	finish    
覆	fù	to veil    
婬	yín	debauchery    
悔	huǐ	remorse    
上	shàng	above    
分	fēn	branch    
請	qǐng	to ask    
出	chū	to emerge    
己	jǐ	self    
以	yǐ	by means of    
著	zhù/zhuó/zhāo/zhe	attachment / making known    
然	rán	in this way    
合	hé	to unite    
尊	zūn	to honor    
使	shǐ	affliction, proclivities    
宿	sù ● xiù	to stay overnight    
便	biàn	directly    
居	jū	be    
向	xiàng	to tend toward    
世	shì	world    
家	jiā	house    
問	wèn	a question    
莫	mò	no    
取	qǔ	to obtain    
具	jù	to be endowed with    
善	shàn	good    
來	lái	to come    
汝	rǔ	you    
惡	è ● wù	unwholesome    
四	sì	four    
罪	zuì	sin    
教	jiào	teaching    
羅	luó	a net    
亦	yì	also    
共	gòng	in common with    
道	dào	way    
他	tā	other    
於	yú	at    
塔	tǎ	stūpa    
住	zhù	to abide    
尸	shī	a corpse    
今	jīn	now    
手	shǒu	hand    
非	fēi	no    
半	bàn	half    
白	bái	white    
在	zài	to be    
二	èr	two    
婆	pó	an old lady    
舍	shè	a shelter    
經	jīng	scripture    
月	yuè	moon    
至	zhì	to reach to    
捨	shě	to abandon    
欲	yù	desire    
諫	jiàn	to remonstrate    
坐	zuò	to sit    
事	shì	affair, event    
淨	jìng	clear    
處	chù	locus    
病	bìng	to get sick    
知	zhī	to know    
餘	yú	leftover    
入 	rù	to enter    
過	guò ● guō	to go past    
已	yǐ	already    
言	yán	words    
十	shí	ten    
彼	bǐ	that    
佛	fó	buddha    
持	chí	to verify    
所	suǒ	an indicator of the object or the passive    
此	cǐ	this    
受	shòu	sensation    
一	yī	one    
無	wú	nonexistent    
行	xíng	to practice    
故	gù	reason    
自	zì	self    
除	chú	except for    
有	yǒu	there is    
三	sān	three    
語	yǔ	to speak    
食	shí	to eat    
僧	sēng	community of monks and nuns    
我	wǒ	self    
尼	ní	nun    
時	shí	time    
戒	jiè	precepts    
與	yǔ	to take part in    
作	zuò	to create    
人	rén	human being    
中	zhōng	middling    
德	dé	attribute, merit    
諸	zhū	many    
大	dà	great    
如	rú	thus    
學	xué	study    
法	fǎ	dharma    
衣	yī	clothes    
說	shuō	to explain    
得	dé	to obtain    
當	dāng	should be    
者	zhě	the one [who, which]    
應	yìng	should    
不	bù	not    
是	shì	yes    
若	ruò	if    
丘	qiū	mound    
比	bǐ	to compare    
